{
  "frontmatter": {},
  "content": {
    "source": {
      "locale": "en-US",
      "hashes": [
        "c340c67a",
        "94612f25",
        "4cd64b66",
        "198a4971",
        "26e3ffe5",
        "48b88f70",
        "595e675a",
        "7947d2d3",
        "ba08b145",
        "940b1519",
        "499e5031",
        "ed9d5158"
      ]
    },
    "targets": {
      "zh-CN": [
        "c340c67a",
        "94612f25",
        "4cd64b66",
        "198a4971",
        "26e3ffe5",
        "48b88f70",
        "595e675a",
        "7947d2d3",
        "ba08b145",
        "940b1519",
        "499e5031",
        "ed9d5158"
      ]
    }
  }
}
